#####################
# #         #      P#
# # # ##### ### #####
# # #   #     #     #
# # ### ##### # ### #
#   #   # #   #   # #
# ### ### # ##### # #
# # #   # # #     # #
# # ### # # ####### #
#S    #   #         #
#####################