#######
# #  P#
# # ###
#S    #
#######