#############
#P    #   #S#
# ### ### # #
#   #     # #
### ####### #
#   #     # #
# ##### # # #
#       #   #
#############