#####################
#    P#             #
# # ### # ### ### # #
# #     #         # #
# ######        #####
#           #       #
###            #### #
# #     # #   #   # #
# #           # # # #
#S    #         #   #
#####################