#####################
#     #   #     #  P#
# # ### # ### ### # #
# #     #         # #
# ############# #####
#         # #       #
######### # # ##### #
# #     # #   #   # #
# # ### # ##### # # #
#S    #         #   #
#####################