#####
#   #
# P #
#S  #
#####