#########################
#           #     #     #
# ######### # ### ### # #
# #   P   # # #   #   # #
# ### ##### # # ### ### #
#     #       # #     # #
####### ####### ##### # #
#             #       # #
# ##### # ### ######### #
# #   # #   #         # #
# # # ##### ### ### ### #
#   #      S      #     #
#########################