#############
#           #
# ######### #
# #   S   # #
# ### ##### #
#     #  P  #
#############