#################
# # # #  ##2333##
##   ## #########
#  #     #    # #
# # # #  #  #  ## 
# ### ## # # #  # 
#S#   ##   #  # #
# # # #  #  #   #
#  #   #  # ## P#
#################